TILEMAP 
16 22 
40 20 
images/tilesheet.png 
3 1 
1111111111111111
1              1
1              1
1              1
1         4    1
1  2222222222  1
1  1        1  1
1  1        1  1
1  1222222221  1
1              1
1              1
1  2222222222  1
1  1        1  1
1  1        1  1
1  1222222221  1
1              1
1              1
1  2222222222  1
1              1
1              1
1222222222222221
1111111111111111
