TILEMAP 
16 22 
40 20 
images/tilesheet.png 
2 2 
1111111111111111
1              1
1              1
1     8 8      1
1         4    1
1   22222222   1
1  8 8 11 8    1
1      11      1
1  2222112222  1
1  8 6 1186 8  1
1      11      1
1 222221122222 1
1 8         8  1
1              1
1 22        22 1
1            8 1
1              1
1 2          2 1
18 3 8     3 9 1
1              1
122222    222221
1111115555111111
