TILEMAP 
16 22 
40 20 
images/tilesheet.png 
2 2 
1111111111111111
1              1
1              1
1  8    8      1
1         4    1
1  2222222222  1
1  1 8    8 1  1
1  1        1  1
1  1222222221  1
1    8 8   8   1
1              1
1  2222222222  1
1  1   8   81  1
1  1        1  1
1  1222222221  1
1    8    8    1
1              1
1  2222222222  1
1    8    8   81
1              1
1222222222222221
1111111111111111
