TILEMAP 
16 22 
40 20 
images/tilesheet.png 
2 2 
1111111111111111
1              1
1              1
1    8  8   8  1
1         4    1
1  2222222222  1
1  1  8  8 81  1
1  1        1  1
1  1222222221  1
1    8   8  8  1
1              1
1  2222222222  1
1   8  118  8  1
1      11      1
1  2222112222  1
1  88 811  88  1
1      11      1
1  2222112222  1
1  8 8      8 81
1              1
122222    222221
1111115555111111
